



NO ./textures/no.xpm
SO ./textures/so.xpm
EA ./textures/est.xpm
WE ./textures/we.xpm
DO ./textures/door.xpm



C 84,107,171

F 61,43,3



        1111111111111111111111111
        1000000000011000000000001
        1000000001110000010000001
        1000000000000000101000001
111111111011000001110000010000001
100000000011000001110000110001111
11110111111111011100000010001
11110011111111111111111111011
11000000110101011100000100001
10000000000000011000000100001
1000000000000000000101000N001
11001001010101011111001100001
1111 11111110101 111101100001
1111 11111111111 111111111111
            



